
NO ./images/north.xpm
SO ./images/south.xpm
WE ./images/west.xpm
EA ./images/east.xpm

F 220,100,10
C 225,255,45

1111111111111111111111111111111111111
1000000000000000000000000000000000001
1000000000000000000000000000000000001
1000000000000000000000000000000000001
1000000000000000000000000000000000001
1000000000000000000000000000000000001
1000000000000000000000000000000000001
1001000000000000000000000000000000001
1000000000000000000000000000000000001
110100000W000000000000000000000000001
1011000000000000000000000000000000001
1111111111111111111111111111111111111
