
NO ./images/north.xpm
SO ./images/hitler.xpm
WE ./images/south.xpm
EA ./images/east.xpm

F 0,120,0
C 0,0,120

1111111111111111111111111111111111111
  11000000000000000000000000000000001
   1000000000000000000000000000000001
   1100000000000000000000000000000001
    100000010000000000000000000000001
11111000000d0000000E00000000000000001
1000000000010000000000000000000000001
1001000000000000000000000000000000001
1000000000000000000000000000000000001
1D11000000000000000000000000000000001
1011000000000011D11000000000000000001
1011000000000000000000000000000000001
1011000000000000000011000000000000001
1011000000000000000000000000000000001
1011000000000000000000000000000000001
1011000000000000000000000000000000001
1011000000000000000000000000000000001
1011000000000000000000000000000000001
1011000000000000000000000000000000001
1011000000000001110000000000000000001
1011000000000000D00000000000000000001
1011000000000000110000000000000000001
1011000000000000010000000000000000001
1011000000000000010000000000000000001
1011000000000000010000000000000000001
1011000000000000001000000000000000001
1011000000000000000010000000000000001
1011000000000000001000000000000000001
1011000000000000000000000000000000001
1011000000000000000000000000000000001
1011000000000000000000000000000000001
1011000000000000000000000000000000001
1011000000000000000000000000000000001
1011000000000000000000000000000000001
1011000000000000000000000000000000001
1011000000000000000000000000000000001
1011000000000000000000000000000000001
1011000000000000000000000000000000001
1011000000000000000000000000000000001
1111111111111111111111111111111111111
