NO ./images/north.xpm
SO ./images/hitler.xpm
WE ./images/south.xpm
EA ./images/east.xpm

F 0,120,0
C 

        1111111111111111111111111
       11000001000110000000000001
        1011000001110000000000001
        1001000000D00000000001111
111111  101100011111d1111111111 
1111011 11111101 100000010001    
11110111111111d1 101010010001
11000000110101011100000010001
100000000000000000000000D0001
10000000000000011101010010001
1100000111010101 111011110N0111
11110111 1110101 101111010001
11111111 1111111 111111111111
